"filename", "language", "JavaScript", "CSS", "XML", "comment", "blank", "total"
"c:\React\see-u-letter\src\App.js", "JavaScript", 53, 0, 0, 3, 11, 67
"c:\React\see-u-letter\src\Screens\LetterOptionsFlow\FontOptionsScreen.js", "JavaScript", 221, 0, 0, 25, 49, 295
"c:\React\see-u-letter\src\Screens\LetterOptionsFlow\LetterPaperOptionsScreen.js", "JavaScript", 36, 0, 0, 0, 13, 49
"c:\React\see-u-letter\src\Screens\LetterOptionsFlow\MonthOptionsScreen.js", "JavaScript", 83, 0, 0, 1, 28, 112
"c:\React\see-u-letter\src\Screens\LetterOptionsFlow\ReceiverOptionsScreen.js", "JavaScript", 73, 0, 0, 8, 23, 104
"c:\React\see-u-letter\src\Screens\LetterOptionsFlow\TopicOptionsIntroScreen.js", "JavaScript", 67, 0, 0, 1, 20, 88
"c:\React\see-u-letter\src\Screens\LetterOptionsFlow\TopicOptionsScreen.js", "JavaScript", 86, 0, 0, 4, 21, 111
"c:\React\see-u-letter\src\Screens\PayFlow\DeliveryInfoScreen.js", "JavaScript", 180, 0, 0, 13, 67, 260
"c:\React\see-u-letter\src\Screens\PhotoUploadScreen.js", "JavaScript", 86, 0, 0, 2, 31, 119
"c:\React\see-u-letter\src\Screens\ServiceIntroductionFlow\FaQData.js", "JavaScript", 13, 0, 0, 0, 3, 16
"c:\React\see-u-letter\src\Screens\ServiceIntroductionFlow\FaQScreen.js", "JavaScript", 178, 0, 0, 1, 51, 230
"c:\React\see-u-letter\src\Screens\ServiceIntroductionFlow\IntroScreen.js", "JavaScript", 64, 0, 0, 0, 16, 80
"c:\React\see-u-letter\src\Screens\ServiceIntroductionFlow\LandingScreen.js", "JavaScript", 12, 0, 0, 0, 4, 16
"c:\React\see-u-letter\src\Screens\ServiceIntroductionFlow\MainScreen.js", "JavaScript", 205, 0, 0, 5, 55, 265
"c:\React\see-u-letter\src\Screens\ServiceIntroductionFlow\SenderInfoScreen.js", "JavaScript", 136, 0, 0, 1, 29, 166
"c:\React\see-u-letter\src\Screens\ServiceIntroductionFlow\TermsOfServiceScreen.js", "JavaScript", 84, 0, 0, 0, 25, 109
"c:\React\see-u-letter\src\Screens\WritingLetterFlow\TryQuill.js", "JavaScript", 105, 0, 0, 21, 30, 156
"c:\React\see-u-letter\src\Screens\WritingLetterFlow\WritingLetter.js", "JavaScript", 160, 0, 0, 46, 59, 265
"c:\React\see-u-letter\src\Screens\WritingLetterScreen.js", "JavaScript", 0, 0, 0, 34, 0, 34
"c:\React\see-u-letter\src\Screens\Writingcopy.js", "JavaScript", 28, 0, 0, 0, 8, 36
"c:\React\see-u-letter\src\Screens\t.css", "CSS", 0, 55, 0, 0, 8, 63
"c:\React\see-u-letter\src\Screens\testModalS.js", "JavaScript", 12, 0, 0, 1, 5, 18
"c:\React\see-u-letter\src\Screens\tt.js", "JavaScript", 119, 0, 0, 18, 9, 146
"c:\React\see-u-letter\src\axios\auth.js", "JavaScript", 20, 0, 0, 0, 5, 25
"c:\React\see-u-letter\src\commons\Header.js", "JavaScript", 35, 0, 0, 0, 9, 44
"c:\React\see-u-letter\src\commons\StyledLink.js", "JavaScript", 0, 0, 0, 0, 1, 1
"c:\React\see-u-letter\src\commons\text.js", "JavaScript", 97, 0, 0, 16, 33, 146
"c:\React\see-u-letter\src\commons\topicsToMe.js", "JavaScript", 2, 0, 0, 0, 0, 2
"c:\React\see-u-letter\src\components\Carousel\Carousel.js", "JavaScript", 98, 0, 0, 0, 11, 109
"c:\React\see-u-letter\src\components\Carousel\Carousels.js", "JavaScript", 119, 0, 0, 50, 16, 185
"c:\React\see-u-letter\src\components\Carousel\LetterPaperCarousel.js", "JavaScript", 62, 0, 0, 0, 20, 82
"c:\React\see-u-letter\src\components\Carousel\slick-theme.css", "CSS", 0, 157, 0, 16, 32, 205
"c:\React\see-u-letter\src\components\Carousel\slick.css", "CSS", 0, 104, 0, 1, 14, 119
"c:\React\see-u-letter\src\components\Carousel\test.css", "CSS", 0, 7, 0, 0, 2, 9
"c:\React\see-u-letter\src\components\Modal\app.js", "JavaScript", 20, 0, 0, 1, 6, 27
"c:\React\see-u-letter\src\components\Modal\component.js", "JavaScript", 102, 0, 0, 3, 36, 141
"c:\React\see-u-letter\src\components\Modal\modal.js", "JavaScript", 41, 0, 0, 0, 8, 49
"c:\React\see-u-letter\src\components\Modal\modalContext.js", "JavaScript", 15, 0, 0, 0, 3, 18
"c:\React\see-u-letter\src\components\Modal\useModal.js", "JavaScript", 12, 0, 0, 0, 4, 16
"c:\React\see-u-letter\src\components\TryModal\Modal.js", "JavaScript", 31, 0, 0, 1, 10, 42
"c:\React\see-u-letter\src\components\TryModal\style.css", "CSS", 0, 75, 0, 0, 7, 82
"c:\React\see-u-letter\src\components\forMainScreen\Footer.js", "JavaScript", 71, 0, 0, 0, 21, 92
"c:\React\see-u-letter\src\components\forMainScreen\Sidebar.js", "JavaScript", 121, 0, 0, 0, 43, 164
"c:\React\see-u-letter\src\components\forMainScreen\SwipeableTemporaryDrawer.js", "JavaScript", 82, 0, 0, 0, 22, 104
"c:\React\see-u-letter\src\components\forPhotoUploadScreen\App.css", "CSS", 0, 7, 0, 0, 2, 9
"c:\React\see-u-letter\src\components\forPhotoUploadScreen\CropImage.js", "JavaScript", 79, 0, 0, 23, 12, 114
"c:\React\see-u-letter\src\components\forPhotoUploadScreen\ImgDialog.js", "JavaScript", 77, 0, 0, 0, 9, 86
"c:\React\see-u-letter\src\components\forPhotoUploadScreen\canvasUtils.js", "JavaScript", 63, 0, 0, 15, 15, 93
"c:\React\see-u-letter\src\components\forPhotoUploadScreen\index.js", "JavaScript", 84, 0, 0, 22, 13, 119
"c:\React\see-u-letter\src\components\forPhotoUploadScreen\styles.js", "JavaScript", 44, 0, 0, 0, 1, 45
"c:\React\see-u-letter\src\contexts\ExtraPages.js", "JavaScript", 5, 0, 0, 0, 1, 6
"c:\React\see-u-letter\src\fonts\font.js", "JavaScript", 10, 0, 0, 0, 4, 14
"c:\React\see-u-letter\src\index.css", "CSS", 0, 42, 0, 0, 9, 51
"c:\React\see-u-letter\src\index.js", "JavaScript", 13, 0, 0, 0, 2, 15
"c:\React\see-u-letter\src\logo.svg", "XML", 0, 0, 1, 0, 0, 1
"Total", "-", 3304, 447, 1, 332, 936, 5020